{
    "name": "Level 3",
    "dependencies": [ "maze2" ],
    "order": "lvl-2",
    "maze": [
        [4, 1, 1, 1, 1, 1, 1, 1, 1, 1, 1, 1, 1, 1, 1, 1, 1, 1, 1, 1, 1, 1, 1, 1, 1, 1, 1, 1, 1, 1, 1, 1, 4],
        [1, 0, 0, 0, 0, 1, 0, 0, 0, 0, 0, 0, 0, 0, 0, 0, 0, 1, 0, 0, 0, 0, 0, 0, 0, 0, 0, 0, 0, 0, 0, 0, 1],
        [1, 0, 1, 1, 1, 1, 0, 1, 1, 1, 1, 1, 1, 0, 0, 0, 0, 1, 0, 0, 0, 0, 0, 0, 0, 0, 0, 0, 0, 0, 0, 0, 1],
        [1, 0, 1, 0, 0, 1, 0, 1, 0, 0, 0, 0, 1, 0, 0, 1, 1, 1, 1, 1, 1, 1, 1, 1, 1, 1, 1, 1, 1, 1, 1, 0, 1],
        [1, 0, 1, 0, 0, 1, 1, 1, 1, 1, 0, 0, 1, 0, 0, 1, 0, 0, 0, 0, 1, 0, 0, 0, 0, 0, 1, 0, 0, 0, 1, 0, 1],
        [1, 0, 1, 0, 0, 1, 0, 0, 0, 1, 0, 0, 1, 0, 0, 1, 0, 0, 0, 0, 1, 1, 1, 1, 0, 0, 1, 0, 0, 0, 1, 0, 1],
        [1, 0, 1, 0, 0, 1, 0, 0, 0, 1, 0, 0, 1, 1, 1, 1, 1, 1, 1, 1, 1, 0, 0, 1, 0, 0, 1, 1, 1, 1, 1, 1, 1],
        [1, 0, 1, 0, 0, 1, 0, 0, 0, 1, 0, 0, 0, 0, 0, 1, 0, 0, 1, 0, 0, 0, 0, 1, 0, 0, 0, 0, 1, 0, 0, 0, 1],
        [1, 0, 1, 0, 0, 1, 1, 1, 1, 1, 0, 0, 0, 0, 0, 1, 0, 0, 1, 0, 0, 0, 0, 1, 0, 0, 0, 0, 1, 0, 0, 0, 1],
        [1, 0, 1, 0, 0, 0, 0, 1, 0, 0, 0, 0, 0, 1, 1, 1, 1, 1, 1, 1, 1, 1, 1, 1, 0, 0, 0, 0, 1, 0, 0, 0, 1],
        [1, 0, 1, 1, 1, 1, 1, 1, 1, 1, 1, 0, 0, 1, 0, 1, 0, 0, 0, 0, 0, 0, 0, 0, 1, 1, 1, 0, 1, 0, 0, 0, 1],
        [1, 0, 1, 0, 0, 0, 0, 1, 0, 0, 1, 0, 0, 1, 0, 1, 1, 0, 0, 0, 0, 0, 0, 0, 1, 0, 1, 0, 1, 0, 0, 0, 1],
        [1, 0, 1, 0, 0, 0, 0, 1, 0, 0, 1, 0, 0, 1, 0, 0, 1, 1, 0, 0, 0, 0, 0, 0, 1, 0, 1, 0, 1, 0, 0, 0, 1],
        [1, 0, 1, 1, 1, 1, 1, 1, 1, 1, 1, 0, 0, 1, 0, 0, 0, 1, 1, 0, 0, 0, 0, 0, 1, 1, 1, 1, 1, 1, 0, 0, 1],
        [1, 0, 0, 0, 0, 0, 0, 0, 0, 0, 0, 0, 0, 1, 0, 0, 0, 0, 1, 1, 0, 0, 0, 0, 1, 5, 1, 1, 1, 1, 1, 1, 1],
        [1, 0, 0, 0, 1, 1, 1, 1, 1, 0, 0, 0, 0, 1, 1, 1, 0, 0, 0, 1, 1, 0, 0, 0, 1, 1, 1, 1, 1, 1, 0, 0, 1],
        [1, 0, 0, 0, 1, 0, 0, 0, 0, 0, 0, 0, 0, 0, 0, 1, 0, 0, 0, 0, 1, 0, 0, 0, 1, 1, 2, 1, 1, 1, 1, 1, 1],
        [1, 0, 0, 0, 1, 0, 0, 0, 0, 0, 0, 0, 0, 0, 0, 1, 0, 0, 0, 0, 1, 1, 1, 1, 1, 1, 1, 1, 1, 1, 0, 0, 1],
        [1, 0, 0, 0, 1, 1, 1, 1, 1, 1, 1, 1, 0, 0, 0, 1, 0, 0, 0, 0, 1, 0, 1, 0, 1, 1, 1, 1, 5, 1, 1, 1, 1],
        [1, 0, 0, 0, 0, 0, 0, 0, 0, 0, 0, 1, 0, 0, 0, 1, 1, 1, 1, 1, 1, 0, 1, 0, 1, 1, 1, 1, 1, 1, 0, 0, 1],
        [1, 0, 0, 0, 0, 0, 0, 0, 0, 0, 0, 1, 1, 1, 0, 0, 0, 0, 0, 0, 0, 0, 1, 0, 0, 1, 0, 1, 0, 0, 0, 0, 1],
        [1, 3, 3, 0, 0, 0, 0, 0, 0, 0, 0, 1, 0, 1, 0, 1, 1, 1, 1, 7, 0, 0, 1, 0, 0, 1, 0, 1, 0, 0, 0, 0, 1],
        [1, 3, 1, 1, 1, 1, 1, 1, 1, 1, 1, 1, 0, 1, 0, 1, 0, 0, 0, 0, 0, 0, 1, 1, 1, 1, 0, 1, 0, 0, 0, 0, 1],
        [1, 3, 3, 0, 0, 0, 0, 1, 0, 0, 0, 0, 0, 1, 0, 1, 0, 0, 0, 0, 0, 0, 0, 0, 0, 0, 0, 1, 1, 1, 1, 0, 1],
        [1, 0, 0, 0, 0, 0, 0, 1, 1, 1, 0, 0, 0, 1, 0, 1, 7, 1, 0, 0, 0, 0, 0, 0, 0, 0, 0, 0, 0, 0, 1, 0, 1],
        [1, 3, 6, 1, 0, 0, 0, 0, 0, 1, 0, 0, 0, 1, 0, 1, 0, 1, 0, 0, 0, 0, 0, 0, 0, 0, 0, 0, 0, 0, 1, 0, 1],
        [1, 0, 0, 1, 0, 0, 0, 0, 0, 1, 0, 0, 0, 1, 0, 0, 0, 1, 3, 3, 1, 1, 1, 1, 0, 0, 0, 0, 0, 0, 1, 0, 1],
        [1, 0, 0, 1, 1, 1, 1, 1, 1, 1, 0, 0, 0, 1, 1, 1, 1, 1, 0, 0, 1, 0, 0, 1, 0, 0, 0, 0, 0, 0, 1, 0, 1],
        [1, 0, 0, 0, 0, 0, 0, 0, 0, 1, 0, 0, 0, 0, 0, 0, 0, 0, 0, 0, 1, 0, 0, 1, 1, 1, 1, 1, 1, 1, 1, 0, 1],
        [1, 0, 0, 0, 0, 0, 0, 0, 0, 1, 0, 0, 0, 0, 0, 0, 0, 0, 0, 0, 1, 0, 0, 0, 1, 0, 0, 0, 0, 0, 0, 0, 1],
        [1, 0, 0, 0, 0, 0, 0, 0, 0, 1, 1, 1, 1, 1, 1, 1, 1, 1, 1, 1, 1, 0, 0, 0, 1, 1, 1, 1, 1, 1, 6, 0, 1],
        [1, 0, 0, 0, 0, 0, 0, 0, 0, 0, 0, 0, 0, 0, 0, 0, 0, 0, 0, 0, 0, 0, 0, 0, 0, 0, 0, 0, 0, 0, 0, 0, 1],
        [4, 1, 1, 1, 1, 1, 1, 1, 1, 1, 1, 1, 1, 1, 1, 1, 1, 1, 1, 1, 1, 1, 1, 1, 1, 1, 1, 1, 1, 1, 1, 1, 4]



    ],
    "enemies": [
        { "pos": [ 2, 8 ], "type": 2 },
        { "pos": [ 3, 16 ], "type": 3 },
        { "pos": [ 3, 28 ], "type": 1 },
        { "pos": [ 6, 2 ], "type": 2 },
        { "pos": [ 6, 13 ], "type": 5 },
        { "pos": [ 6, 17 ], "type": 5 },
        { "pos": [ 8, 8 ], "type": 3 },
        { "pos": [ 8, 15 ], "type": 5 },
        { "pos": [ 8, 28 ], "type": 1 },
        { "pos": [ 9, 21 ], "type": 2 },
        { "pos": [ 10, 25 ], "type": 3 },
        { "pos": [ 11, 0 ], "type": 2 },
        { "pos": [ 13, 4 ], "type": 1 },
        { "pos": [ 13, 13 ], "type": 1 },
        { "pos": [ 13, 18 ], "type": 1 },
        { "pos": [ 14, 32 ], "type": 1 },
        { "pos": [ 18, 6 ], "type": 1 },
        { "pos": [ 18, 15 ], "type": 2 },
        { "pos": [ 21, 27 ], "type": 2 },
        { "pos": [ 21, 32 ], "type": 2 },
        { "pos": [ 24, 8 ], "type": 1 },
        { "pos": [ 28, 23 ], "type": 3 },
        { "pos": [ 28, 27 ], "type": 1 },
        { "pos": [ 30, 9 ], "type": 3 },
        { "pos": [ 30, 11 ], "type": 5 },
        { "pos": [ 30, 13 ], "type": 4 },
        { "pos": [ 30, 15 ], "type": 5 },
        { "pos": [ 30, 17 ], "type": 4 },
        { "pos": [ 32, 7 ], "type": 3 },
        { "pos": [ 32, 28 ], "type": 1 }
        
    ],
    "start": [ 6, 15 ],
    "end": [ 25, 15 ],
    "player": {
        "hp": 187,
        "damage": 35
    },
    "tiles": {
        "2": {
            "spawner": {
                "enemy": 1,
                "cooldown": 2
            },
            "name": "{bold.green Spawner}",
            "mapName": "{bold.green 1}"
        },
        "3": {
            "wall": true,
            "name": "{bold.rgb(235,143,52) Lava}",
            "mapName": "{bold.rgb(235,143,52) #}"
        },
        "4": {
            "portal": {
                "id": "1"
            },
            "name": "{bold.rgb(0,255,255) Portal 1}",
            "mapName": "{bold.rgb(0,255,255) 2}"
        },
        "5": {
            "portal": {
                "id": "2"
            },
            "name": "{bold.rgb(0,255,255) Portal 2}",
            "mapName": "{bold.rgb(0,255,255) 3}"
        },
        "6": {
            "portal": {
                "id": "3"
            },
            "name": "{bold.rgb(0,255,255) Portal 3}",
            "mapName": "{bold.rgb(0,255,255) 4}"
        },
        "7": {
            "portal": {
                "id": "4"
            },
            "name": "{bold.rgb(0,255,255) Portal 4}",
            "mapName": "{bold.rgb(0,255,255) 5}"
        }
    }
}