{
    "maze":[
        [1, 1, 1, 1, 1, 0, 0, 0, 0, 0],
        [1, 0, 0, 0, 0, 0, 0, 0, 0, 0],
        [1, 0, 0, 0, 0, 0, 0, 0, 0, 0],
        [1, 0, 0, 0, 0, 1, 1, 1, 1, 0],
        [1, 1, 1, 1, 0, 1, 0, 0, 1, 0],
        [0, 0, 0, 1, 1, 1, 0, 1, 1, 1],
        [0, 0, 0, 0, 0, 1, 0, 1, 0, 1],
        [0, 0, 0, 1, 0, 1, 0, 1, 1, 1],
        [0, 0, 0, 1, 1, 1, 0, 0, 0, 1],
        [0, 0, 0, 0, 0, 0, 0, 0, 0, 1]
    ],
    "enemies":[
        [-1, -1, -1,  1, -1, -1, -1, -1, -1, -1],
        [-1, -1, -1, -1, -1, -1, -1, -1, -1, -1],
        [-1, -1, -1, -1, -1, -1, -1, -1, -1, -1],
        [-1, -1, -1, -1, -1, -1, -1, -1, -1, -1],
        [-1,  1, -1, -1, -1, -1, -1, -1,  3, -1],
        [-1, -1, -1, -1, -1, -1, -1, -1, -1, -1],
        [-1, -1, -1, -1, -1, -1, -1,  1, -1, -1],
        [-1, -1, -1,  3, -1, -1, -1, -1, -1,  3],
        [-1, -1, -1, -1, -1,  2, -1, -1, -1, -1],
        [-1, -1, -1, -1, -1, -1, -1, -1, -1, -1]
    ],
    "start": [0, 0],
    "end": [9, 9],
    "player": {
        "hp": 100,
        "damage": 24
    }
}