{
    "name": "Bewegungstutorial",
    "dependencies": [ ],
    "tutorial": true,
    "order": "tut-0",
    "maze": [
        [ 0, 0, 0, 0, 0, 0, 0, 0, 0, 0, 0, 0, 0, 0, 0, 0, 0, 0 ],
        [ 0, 1, 1, 1, 1, 1, 1, 0, 1, 1, 1, 1, 1, 1, 1, 1, 1, 0 ],
        [ 0, 1, 1, 1, 1, 1, 1, 0, 1, 1, 0, 0, 1, 1, 1, 1, 1, 0 ],
        [ 0, 1, 1, 1, 1, 1, 1, 1, 1, 1, 0, 1, 1, 1, 1, 1, 1, 0 ],
        [ 0, 0, 0, 0, 0, 0, 0, 0, 0, 0, 0, 0, 0, 0, 0, 0, 0, 0 ]
    ],
    "enemies": [ ],
    "start": [ 2, 2 ],
    "end": [ 2, 14 ],
    "player": {
        "hp": 100,
        "damage": 24
    }
}